111111111111111111
100E10000000000001
100110000001C00001
100000000001111101
100P00000001C00001
100000000001000001
100C00000001000001
111111111111111111